0 0 0 0 0 0 0 0 0 0 0 0 0 0 0 0 0 0 0 0 0 0 0 0 0 0 0 0 0 0 0 0 0 0 0 0 0 0 0 0 0 0 0 0 0 0 0 0 0 0 0 0 0 0 0 0 0 0 0 0 0 0 0 0 0 0 0 0 0 0 0 0 0 0 0 0 0 0 0 0 0 0 0 0 0 0 0 0 0 0 0 0 0 0 0 0 0 0 0 0 
0 0 0 0 0 0 0 0 0 0 0 0 0 0 0 0 0 0 0 0 0 0 0 0 0 0 0 0 0 0 0 0 0 0 0 0 0 0 0 0 0 0 0 0 0 0 0 0 0 0 0 0 0 0 0 0 0 0 0 0 0 0 0 0 0 0 0 0 0 0 0 0 0 0 0 0 0 0 0 0 0 0 0 0 0 0 0 0 0 0 0 0 0 0 0 0 0 0 0 0 
0 0 0 0 0 0 0 0 0 0 0 0 0 0 0 0 0 0 0 0 0 0 0 0 0 0 0 0 0 0 0 0 0 0 0 0 0 0 0 0 0 0 0 0 0 0 0 0 0 0 0 0 0 0 0 0 0 0 0 0 0 0 0 0 0 0 0 0 0 0 0 0 0 0 0 0 0 0 0 0 0 0 0 0 0 0 0 0 0 0 0 0 0 0 0 0 0 0 0 0 
0 0 0 0 0 0 0 0 0 0 0 0 0 0 0 0 0 0 0 0 0 0 0 0 0 0 0 0 0 0 0 0 0 0 0 0 0 0 0 0 0 0 0 0 0 0 0 0 0 0 0 0 0 0 0 0 0 0 0 0 0 0 0 0 0 0 0 0 0 0 0 0 0 0 0 0 0 0 0 0 0 0 0 0 0 0 0 0 0 0 0 0 0 0 0 0 0 0 0 0 
0 0 0 0 0 0 0 0 0 0 0 0 0 0 0 0 0 0 0 0 0 0 0 0 0 0 0 0 0 0 0 0 0 0 0 0 0 0 0 0 0 0 0 0 0 0 0 0 0 0 0 0 0 0 0 0 0 0 0 0 0 0 0 0 0 0 0 0 0 0 0 0 0 0 0 0 0 0 0 0 0 0 0 0 0 0 0 0 0 0 0 0 0 0 0 0 0 0 0 0 
0 0 0 0 0 0 0 0 0 0 0 0 0 0 0 0 0 0 0 0 0 0 0 0 0 0 0 0 0 0 0 0 0 0 0 0 0 0 0 0 0 0 0 0 0 0 0 0 0 0 0 0 0 0 0 0 0 0 0 0 0 0 0 0 0 0 0 0 0 0 0 0 0 0 0 0 0 0 0 0 0 0 0 0 0 0 0 0 0 0 0 0 0 0 0 0 0 0 0 0 
0 0 0 0 0 0 0 0 0 0 0 0 0 0 0 0 0 0 0 0 0 0 0 0 0 0 0 0 0 0 0 0 0 0 0 0 0 0 0 0 0 0 0 0 0 0 0 0 0 0 0 0 0 0 0 0 0 0 0 0 0 0 0 0 0 0 0 0 0 0 0 0 0 0 0 0 0 0 0 0 0 0 0 0 0 0 0 0 0 0 0 0 0 0 0 0 0 0 0 0 
0 0 0 0 0 0 0 0 0 0 0 0 0 0 0 0 0 0 0 0 0 0 0 0 0 0 0 0 0 0 0 0 0 0 0 0 0 0 0 0 0 0 0 0 0 0 0 0 0 0 0 0 0 0 0 0 0 0 0 0 0 0 0 0 0 0 0 0 0 0 0 0 0 0 0 0 0 0 0 0 0 0 0 0 0 0 0 0 0 0 0 0 0 0 0 0 0 0 0 0 
0 0 0 0 0 0 0 0 0 0 0 0 0 0 0 0 0 0 0 0 0 0 0 0 0 0 0 0 0 0 0 0 0 0 0 0 0 0 0 0 0 0 0 0 0 0 0 0 0 0 0 0 0 0 0 0 0 0 0 0 0 0 0 0 0 0 0 0 0 0 0 0 0 0 0 0 0 0 0 0 0 0 0 0 0 0 0 0 0 0 0 0 0 0 0 0 0 0 0 0 
0 0 0 0 0 0 0 0 0 0 0 0 0 0 0 0 0 0 0 0 0 0 0 0 0 0 0 0 0 0 0 0 0 0 0 0 0 0 0 0 0 0 0 0 0 0 0 0 0 0 0 0 0 0 0 0 0 0 0 0 0 0 0 0 0 0 0 0 0 0 0 0 0 0 0 0 0 0 0 0 0 0 0 0 0 0 0 0 0 0 0 0 0 0 0 0 0 0 0 0 
0 0 0 0 0 0 0 0 0 0 3 6 6 6 6 6 6 6 6 6 6 6 6 6 6 6 6 6 6 6 6 6 6 6 6 6 6 6 6 6 6 6 6 6 6 6 6 6 6 6 6 6 6 6 6 6 6 6 6 6 6 6 6 6 6 6 6 6 6 6 6 6 6 6 6 6 6 6 6 6 6 6 6 6 6 6 6 6 6 6 4 0 0 0 0 0 0 0 0 0 
0 0 0 0 0 0 0 0 0 0 7 35 35 35 35 35 35 35 35 35 35 9 9 9 9 35 9 35 9 10 12 12 35 9 10 9 9 14 12 9 12 9 9 9 9 32 31 30 31 31 31 30 31 32 34 34 33 32 31 31 30 31 31 30 31 31 32 33 33 9 9 9 9 9 9 9 9 9 36 36 9 9 35 9 9 35 9 35 35 35 8 0 0 0 0 0 0 0 0 0 
0 0 0 0 0 0 0 0 0 0 7 35 35 35 35 35 35 35 35 35 9 9 9 9 9 9 9 35 10 9 35 9 14 10 9 9 34 9 9 9 9 9 9 9 9 32 29 29 29 29 29 29 29 32 33 34 33 32 29 29 29 29 29 29 29 29 32 32 31 31 30 31 32 9 37 9 9 9 9 9 9 9 9 35 9 9 36 9 9 9 8 0 0 0 0 0 0 0 0 0 
0 0 0 0 0 0 0 0 0 0 7 35 35 35 35 35 35 35 35 9 9 9 9 9 9 35 9 34 10 10 34 14 14 35 9 14 9 14 9 12 9 9 9 9 9 32 29 29 29 29 29 29 29 32 9 33 33 32 29 29 29 29 29 29 29 29 29 29 29 29 29 29 32 9 9 9 9 9 9 9 9 9 9 9 9 9 36 9 35 9 8 0 0 0 0 0 0 0 0 0 
0 0 0 0 0 0 0 0 0 0 7 35 35 35 35 35 35 9 9 9 9 9 9 33 9 34 34 10 34 9 35 14 9 34 14 9 35 9 34 9 9 9 9 9 9 32 29 29 29 29 29 29 29 32 9 9 9 32 29 29 29 29 29 29 29 29 29 29 29 29 29 29 32 9 9 9 9 9 36 9 9 9 9 35 9 9 9 9 9 9 8 0 0 0 0 0 0 0 0 0 
0 0 0 0 0 0 0 0 0 0 7 35 35 35 35 35 9 9 9 9 9 9 33 33 9 9 12 12 12 35 9 9 35 10 10 10 9 12 12 9 9 9 34 9 9 31 31 30 30 31 30 28 30 31 9 9 9 31 31 30 31 31 30 31 31 28 31 31 30 31 30 31 32 9 9 9 9 9 9 9 9 9 9 35 9 9 9 9 9 35 8 0 0 0 0 0 0 0 0 0 
0 0 0 0 0 0 0 0 0 0 7 35 35 35 35 9 9 9 9 9 9 33 9 9 32 31 31 31 31 31 31 31 31 31 31 31 31 31 31 31 31 32 9 9 9 9 9 9 9 9 9 9 9 9 9 9 9 9 9 9 9 9 9 9 33 9 33 9 9 9 9 9 9 9 9 9 9 9 9 9 9 9 9 9 9 9 9 9 9 9 8 0 0 0 0 0 0 0 0 0 
0 0 0 0 0 0 0 0 0 0 7 35 35 35 9 9 9 9 9 9 9 33 9 9 32 29 29 29 29 29 29 29 29 29 29 29 29 29 29 29 29 32 9 9 9 9 9 9 9 9 9 9 9 9 9 9 9 9 10 14 14 14 14 14 9 9 9 9 9 9 13 15 9 9 9 9 9 9 9 9 9 9 9 9 9 9 9 35 9 9 8 0 0 0 0 0 0 0 0 0 
0 0 0 0 0 0 0 0 0 0 7 35 35 9 9 9 9 9 9 9 33 9 9 9 32 29 29 29 29 29 29 29 29 29 29 29 29 29 29 29 29 32 9 9 9 9 9 9 9 9 9 9 9 9 9 9 9 9 10 14 14 14 14 14 9 9 9 9 9 18 17 16 9 9 9 9 9 9 9 37 9 9 9 9 9 9 9 9 9 9 8 0 0 0 0 0 0 0 0 0 
0 0 0 0 0 0 0 0 0 0 7 35 9 9 9 9 9 9 9 9 9 9 9 9 32 29 29 29 29 29 29 29 29 29 29 29 29 29 29 29 29 32 9 9 9 9 9 9 9 9 9 9 9 9 9 9 9 9 10 14 14 14 14 14 9 9 9 9 9 9 33 9 9 9 9 9 9 9 9 9 9 9 9 9 37 9 9 9 9 9 8 0 0 0 0 0 0 0 0 0 
0 0 0 0 0 0 0 0 0 0 7 9 9 35 35 9 9 9 9 9 9 9 9 9 32 29 29 29 29 29 29 29 29 29 29 29 29 29 29 29 29 32 9 9 9 9 9 9 9 9 9 9 9 9 9 9 9 9 9 12 12 12 12 12 9 9 9 9 9 9 9 9 9 9 9 9 9 9 37 9 9 9 9 9 9 9 9 9 9 9 8 0 0 0 0 0 0 0 0 0 
0 0 0 0 0 0 0 0 0 0 7 9 9 9 35 9 9 9 9 9 9 9 9 9 32 29 29 29 29 29 29 29 29 29 29 29 29 29 29 29 29 32 9 9 9 9 9 9 9 9 9 9 9 9 9 9 21 27 23 9 9 9 9 9 9 9 9 9 9 9 9 9 9 9 9 9 9 9 9 9 9 9 9 9 9 9 9 9 9 9 8 0 0 0 0 0 0 0 0 0 
0 0 0 0 0 0 0 0 0 0 7 9 9 9 35 9 9 9 9 9 9 9 9 9 32 31 31 31 31 30 31 31 31 31 31 31 31 31 28 30 31 32 9 9 9 9 9 9 9 9 9 9 9 9 9 9 24 22 25 9 9 9 9 9 9 9 9 9 9 9 9 9 9 9 9 9 9 9 9 9 9 9 9 9 9 9 9 9 9 9 8 0 0 0 0 0 0 0 0 0 
0 0 0 0 0 0 0 0 0 0 7 9 9 35 35 9 9 9 9 9 9 9 9 9 9 9 9 9 9 9 9 9 9 9 9 9 9 9 9 9 9 9 9 9 9 9 9 9 9 9 9 9 9 9 9 9 24 22 25 9 9 9 9 9 9 9 9 9 9 9 9 9 9 9 9 9 9 9 9 9 9 9 37 9 9 9 9 9 9 9 8 0 0 0 0 0 0 0 0 0 
0 0 0 0 0 0 0 0 0 0 7 9 9 35 10 9 9 9 9 9 9 9 9 9 9 9 9 9 9 9 9 9 9 9 9 9 9 9 9 9 9 9 9 9 9 9 9 9 9 9 9 9 9 9 9 9 24 22 25 9 9 9 9 9 9 9 9 9 9 9 9 9 9 9 9 9 9 9 9 9 9 9 9 9 9 9 9 9 9 9 8 0 0 0 0 0 0 0 0 0 
0 0 0 0 0 0 0 0 0 0 7 9 9 35 10 10 10 9 11 11 9 9 9 9 33 9 9 9 9 9 9 9 9 9 9 9 9 9 9 9 9 9 9 9 9 9 9 9 9 9 9 9 9 9 9 9 24 22 25 9 9 9 9 9 9 9 9 9 9 9 9 9 9 9 9 9 9 9 9 9 9 9 9 9 9 9 9 9 9 9 8 0 0 0 0 0 0 0 0 0 
0 0 0 0 0 0 0 0 0 0 7 9 9 35 35 35 10 11 11 12 9 9 9 9 9 9 36 9 9 9 9 9 9 9 9 9 9 9 9 9 9 9 31 31 31 30 31 31 31 30 31 31 31 9 9 9 24 22 25 9 9 9 9 9 9 9 9 9 9 9 9 9 9 9 9 9 9 9 9 9 9 9 9 9 9 9 9 9 9 9 8 0 0 0 0 0 0 0 0 0 
0 0 0 0 0 0 0 0 0 0 7 9 9 9 9 35 9 11 12 9 9 9 9 36 9 34 9 9 9 9 9 9 9 9 9 9 9 9 9 9 9 9 32 29 29 29 29 29 29 29 29 29 32 9 9 9 24 22 25 9 9 9 9 9 9 9 9 9 9 9 9 9 9 9 9 9 9 9 9 9 9 9 9 9 9 9 9 9 9 9 8 0 0 0 0 0 0 0 0 0 
0 0 0 0 0 0 0 0 0 0 7 9 9 9 9 35 9 12 12 9 9 9 9 54 9 33 34 9 33 36 9 9 9 9 9 9 9 9 9 9 9 9 32 29 29 29 29 29 29 29 29 29 32 9 9 9 24 22 25 9 9 9 9 9 9 9 9 9 9 9 9 9 9 9 9 9 9 9 9 9 9 9 9 9 9 9 9 9 9 9 8 0 0 0 0 0 0 0 0 0 
0 0 0 0 0 0 0 0 0 0 7 9 9 9 9 9 9 12 10 9 33 9 9 54 54 54 54 9 9 9 9 9 9 9 34 9 9 9 9 9 9 9 32 29 29 29 29 29 29 29 29 29 32 9 9 9 24 22 25 9 9 9 9 9 36 9 9 9 9 9 9 9 9 9 9 9 9 9 9 9 9 9 9 9 9 9 9 9 9 9 8 0 0 0 0 0 0 0 0 0 
0 0 0 0 0 0 0 0 0 0 7 9 9 9 9 9 11 12 10 9 9 9 9 9 33 34 54 36 9 54 54 9 9 9 9 9 9 9 9 9 9 9 32 29 29 29 29 29 29 29 29 29 32 9 9 9 24 22 25 9 9 9 9 9 36 36 36 9 9 9 9 9 9 9 9 9 9 9 9 9 9 9 9 9 9 9 9 9 9 9 8 0 0 0 0 0 0 0 0 0 
0 0 0 0 0 0 0 0 0 0 7 9 9 9 9 9 11 12 10 9 9 9 9 9 36 9 9 9 54 9 9 34 33 9 9 9 9 9 9 9 9 9 31 31 31 31 31 30 31 28 31 30 31 9 9 9 24 22 25 9 9 9 9 9 54 54 9 36 36 36 36 36 9 9 9 9 9 9 9 9 9 9 9 9 9 9 9 9 9 9 8 0 0 0 0 0 0 0 0 0 
0 0 0 0 0 0 0 0 0 0 7 9 9 9 9 9 12 11 9 10 9 9 9 9 9 9 54 54 54 36 9 9 9 9 34 36 9 9 9 9 9 9 9 9 9 9 9 9 9 9 9 9 9 9 9 9 24 22 25 9 9 9 9 9 54 54 54 33 33 9 9 9 36 36 36 9 9 9 9 9 9 9 9 9 9 9 9 9 9 9 8 0 0 0 0 0 0 0 0 0 
0 0 0 0 0 0 0 0 0 0 7 9 9 9 9 12 12 9 9 10 9 9 9 9 34 9 36 9 9 54 33 9 54 9 9 9 9 9 9 9 9 9 9 9 9 9 9 9 9 9 9 9 9 9 9 9 24 22 25 9 9 9 9 9 9 34 54 54 54 54 54 33 33 9 36 36 36 9 9 9 9 9 9 9 9 9 9 9 9 9 8 0 0 0 0 0 0 0 0 0 
0 0 0 0 0 0 0 0 0 0 7 9 9 9 9 9 9 9 9 10 9 9 9 9 33 9 9 9 33 9 54 9 9 9 9 9 9 9 9 9 9 9 9 9 9 9 9 9 9 9 9 9 9 9 9 9 24 22 25 9 9 9 9 9 9 34 9 9 9 9 54 54 54 54 33 33 36 36 36 9 9 9 9 9 9 9 9 9 9 9 8 0 0 0 0 0 0 0 0 0 
0 0 0 0 0 0 0 0 0 0 7 9 9 9 9 9 9 9 9 9 9 9 9 9 9 9 9 9 9 9 9 9 36 9 34 9 9 9 9 9 9 9 9 9 9 9 9 9 9 9 9 9 9 9 9 9 24 22 25 9 9 9 9 9 9 9 9 9 9 34 9 9 9 54 54 54 54 9 36 36 36 9 9 9 9 9 9 9 9 9 8 0 0 0 0 0 0 0 0 0 
0 0 0 0 0 0 0 0 0 0 7 9 9 9 9 9 9 9 9 9 9 9 9 9 9 9 9 9 9 9 9 9 9 9 9 9 9 9 9 9 9 9 9 9 9 9 9 9 9 9 9 9 9 9 9 9 24 22 25 9 9 9 9 9 9 9 9 9 9 9 9 34 9 9 9 9 54 9 33 9 36 36 9 9 9 9 9 9 9 9 8 0 0 0 0 0 0 0 0 0 
0 0 0 0 0 0 0 0 0 0 7 9 9 9 9 9 9 9 9 9 9 9 9 9 9 9 35 35 35 35 35 9 35 35 35 35 9 35 9 9 9 9 9 9 9 9 9 9 9 9 9 9 9 9 9 9 24 22 25 9 9 9 9 9 9 9 9 9 34 9 9 9 9 9 9 34 54 54 54 54 33 36 36 9 9 9 9 9 9 9 8 0 0 0 0 0 0 0 0 0 
0 0 0 0 0 0 0 0 0 0 7 9 9 9 9 9 9 9 9 9 9 35 35 9 35 35 9 9 9 9 35 35 35 9 35 35 35 35 35 35 35 35 9 9 9 9 9 9 9 9 9 9 9 9 9 9 24 22 25 9 9 9 9 9 9 9 9 9 9 9 9 9 9 9 9 9 9 9 9 54 54 33 9 9 9 9 9 9 9 9 8 0 0 0 0 0 0 0 0 0 
0 0 0 0 0 0 0 0 0 0 7 9 9 9 9 9 9 9 9 9 9 35 35 35 35 9 11 11 9 9 11 11 9 9 35 35 11 9 11 9 9 35 35 9 9 9 9 9 9 9 9 9 9 9 9 9 24 22 25 9 9 9 9 9 9 9 41 46 46 46 46 46 46 46 46 46 46 46 46 46 42 9 35 35 9 9 35 9 9 9 8 0 0 0 0 0 0 0 0 0 
0 0 0 0 0 0 0 0 0 0 7 9 9 9 9 9 9 9 9 9 9 35 9 35 9 9 35 35 35 35 35 9 11 11 35 9 11 35 35 35 9 9 35 35 9 9 9 9 9 9 9 9 9 9 9 9 24 22 25 9 9 9 9 9 9 9 43 38 38 38 38 38 38 38 38 38 38 38 38 38 44 9 9 35 35 9 35 9 9 9 8 0 0 0 0 0 0 0 0 0 
0 0 0 0 0 0 0 0 0 0 7 9 9 9 9 9 9 14 9 9 35 35 9 9 9 35 35 9 9 9 35 35 9 9 11 9 35 35 35 35 9 9 9 35 9 9 9 9 9 9 9 9 9 9 9 9 24 22 25 9 9 9 9 9 9 9 43 38 38 38 38 38 38 38 38 38 38 38 38 38 44 9 9 9 35 9 35 9 9 9 8 0 0 0 0 0 0 0 0 0 
0 0 0 0 0 0 0 0 0 0 7 9 9 9 35 35 35 35 14 35 35 9 12 9 35 35 12 9 12 9 9 35 35 35 9 9 35 9 9 35 35 12 9 35 9 9 9 9 9 9 9 9 9 9 9 9 24 22 25 9 9 9 9 9 9 9 43 38 38 38 38 38 38 38 38 38 38 38 38 38 44 9 9 35 35 9 35 35 9 9 8 0 0 0 0 0 0 0 0 0 
0 0 0 0 0 0 0 0 0 0 7 9 9 9 35 35 35 35 14 35 9 9 9 35 35 14 9 14 9 12 14 9 9 35 35 35 35 14 12 12 35 9 9 35 9 9 9 9 9 9 9 9 9 9 9 9 24 22 25 9 9 9 9 9 9 9 43 38 38 38 38 38 38 38 38 38 38 38 38 38 44 9 9 9 35 35 9 35 9 9 8 0 0 0 0 0 0 0 0 0 
0 0 0 0 0 0 0 0 0 0 7 9 9 9 35 35 35 35 14 35 12 9 35 35 9 9 9 9 12 14 14 9 9 9 9 14 9 9 14 9 35 9 12 35 35 9 9 9 9 9 9 9 9 9 9 9 24 22 25 9 9 9 9 9 9 9 43 38 38 38 38 38 38 38 38 38 38 38 38 38 44 9 9 36 9 35 9 35 9 9 8 0 0 0 0 0 0 0 0 0 
0 0 0 0 0 0 0 0 0 0 7 9 9 9 35 35 35 35 9 35 9 12 35 14 9 35 35 35 35 35 9 9 9 35 35 9 35 9 14 9 35 12 9 35 9 9 9 9 9 9 9 9 9 9 9 9 24 22 25 9 9 9 9 9 9 9 43 38 38 38 38 38 38 38 38 38 38 38 38 38 44 9 9 54 35 35 9 35 35 9 8 0 0 0 0 0 0 0 0 0 
0 0 0 0 0 0 0 0 0 0 7 9 9 9 9 35 35 14 14 35 9 35 35 14 9 35 54 54 35 35 35 35 35 35 35 9 35 14 9 35 35 9 12 35 9 9 9 9 9 9 9 9 9 9 9 9 24 22 25 9 9 9 9 9 9 9 43 38 38 38 38 38 38 38 38 38 38 38 38 38 44 9 54 54 35 35 9 9 35 9 8 0 0 0 0 0 0 0 0 0 
0 0 0 0 0 0 0 0 0 0 7 9 9 9 35 35 35 14 35 35 9 35 9 9 35 35 54 33 54 54 54 35 35 9 35 35 35 14 35 35 9 9 35 9 9 9 9 9 9 9 9 9 9 9 9 9 24 22 25 9 9 9 9 9 9 9 43 38 38 38 38 38 38 38 38 38 38 38 38 38 44 9 54 36 9 35 35 35 35 9 8 0 0 0 0 0 0 0 0 0 
0 0 0 0 0 0 0 0 0 0 7 9 9 9 35 35 35 9 9 35 9 35 35 9 35 54 54 54 54 54 54 33 54 54 35 35 9 9 35 9 9 35 35 9 9 9 9 9 9 9 9 9 9 9 9 9 24 22 25 9 9 9 9 9 9 9 43 38 38 38 38 38 38 38 38 38 38 38 38 38 44 9 54 9 9 9 9 35 9 9 8 0 0 0 0 0 0 0 0 0 
0 0 0 0 0 0 0 0 0 0 7 9 9 11 10 35 9 14 35 35 9 9 35 9 35 35 33 54 54 54 54 54 54 35 35 9 9 35 9 9 12 35 9 9 9 9 9 9 9 9 9 9 9 9 9 9 24 22 25 9 9 9 9 9 9 9 43 38 38 38 38 38 38 38 38 38 38 38 38 38 44 9 54 9 35 35 35 36 9 9 8 0 0 0 0 0 0 0 0 0 
0 0 0 0 0 0 0 0 0 0 7 9 9 12 11 35 9 9 35 35 12 9 35 9 9 35 35 54 33 54 33 35 35 9 9 9 35 35 9 9 9 35 9 9 9 9 9 9 9 9 9 9 9 9 9 9 24 22 25 9 9 9 9 9 9 9 43 38 38 38 38 38 38 38 38 38 38 38 38 38 44 9 54 9 35 35 9 36 9 9 8 0 0 0 0 0 0 0 0 0 
0 0 0 0 0 0 0 0 0 0 7 9 9 9 35 9 9 14 9 35 12 9 35 9 9 9 9 9 35 35 35 35 9 14 14 9 35 9 12 12 9 35 35 9 9 9 9 9 9 9 9 9 9 9 9 9 24 22 25 9 9 9 9 9 9 9 43 38 38 38 38 38 38 38 38 38 38 38 38 38 44 9 54 36 9 35 35 9 36 9 8 0 0 0 0 0 0 0 0 0 
0 0 0 0 0 0 0 0 0 0 7 9 9 35 35 35 35 9 9 35 9 9 35 35 35 35 35 35 35 9 9 9 14 14 9 35 35 12 9 9 12 9 35 9 9 9 9 9 9 9 9 9 9 9 9 9 24 22 25 9 9 9 9 9 9 9 39 45 45 45 45 45 45 45 45 45 45 45 45 45 40 9 54 9 9 9 35 36 9 9 8 0 0 0 0 0 0 0 0 0 
0 0 0 0 0 0 0 0 0 0 7 9 9 9 9 35 35 10 9 35 9 12 9 9 14 9 9 9 9 14 9 35 35 35 35 35 9 9 11 9 9 9 35 35 9 9 9 9 9 9 9 9 9 9 9 9 24 22 25 9 9 9 9 9 9 9 9 9 9 9 37 9 9 9 9 9 9 9 9 9 9 9 36 54 54 9 35 36 9 9 8 0 0 0 0 0 0 0 0 0 
0 0 0 0 0 0 0 0 0 0 7 9 9 9 9 35 9 9 9 35 35 35 35 35 35 35 14 9 14 35 35 35 9 9 9 14 11 35 35 9 12 35 35 35 9 9 9 9 9 9 9 9 9 9 9 9 24 22 25 9 9 9 9 9 9 9 9 9 9 9 9 9 9 9 9 9 9 9 9 37 9 9 9 9 9 9 35 36 36 9 8 0 0 0 0 0 0 0 0 0 
0 0 0 0 0 0 0 0 0 0 7 9 9 9 9 35 9 10 10 9 35 35 9 9 9 35 35 35 35 35 9 10 14 14 14 9 35 9 35 35 35 9 9 9 9 9 9 9 9 9 9 9 9 9 9 9 24 22 25 9 9 9 9 9 9 9 9 9 9 9 9 9 37 9 9 37 9 37 9 9 9 9 54 54 54 35 35 9 36 9 8 0 0 0 0 0 0 0 0 0 
0 0 0 0 0 0 0 0 0 0 7 9 9 9 9 35 9 9 9 9 14 9 14 10 14 9 9 9 9 14 14 9 9 10 10 9 35 35 35 9 9 9 9 9 9 9 9 9 9 9 9 9 9 9 9 9 24 22 25 9 9 9 9 9 9 9 9 9 9 9 9 9 9 9 9 9 9 9 9 9 9 54 36 9 9 9 9 9 36 36 8 0 0 0 0 0 0 0 0 0 
0 0 0 0 0 0 0 0 0 0 7 9 9 9 9 35 35 35 9 35 35 35 9 10 9 9 9 35 35 9 9 35 35 35 35 35 35 9 9 9 9 9 9 9 9 9 9 9 9 9 9 9 9 9 9 9 24 22 22 27 27 27 27 27 27 27 27 27 27 27 27 27 27 27 27 27 23 9 9 9 9 9 9 9 9 9 9 9 9 9 8 0 0 0 0 0 0 0 0 0 
0 0 0 0 0 0 0 0 0 0 7 9 9 9 9 9 9 35 35 9 9 9 35 35 35 35 35 35 35 35 35 35 9 9 9 9 9 9 9 9 9 9 9 9 9 9 9 9 9 9 9 9 9 9 9 9 24 22 22 22 22 22 22 22 22 22 22 22 22 22 22 22 22 22 22 22 25 9 9 9 9 9 9 9 9 9 9 9 9 9 8 0 0 0 0 0 0 0 0 0 
0 0 0 0 0 0 0 0 0 0 7 9 9 9 9 9 9 9 9 9 9 9 9 9 9 9 9 9 9 9 9 9 9 9 9 9 9 9 9 9 9 9 9 9 9 9 9 9 9 9 9 9 9 9 9 9 24 22 22 26 26 26 26 26 26 26 26 26 26 26 26 26 26 26 26 26 20 9 9 9 9 9 9 9 9 9 9 9 9 9 8 0 0 0 0 0 0 0 0 0 
0 0 0 0 0 0 0 0 0 0 7 9 9 9 9 9 9 9 9 9 9 9 9 9 9 9 9 9 9 9 9 9 9 9 9 9 9 9 9 9 9 9 9 9 9 9 9 9 9 9 9 9 9 9 9 9 24 22 25 9 9 9 9 9 9 9 9 9 9 9 9 9 9 9 9 9 9 9 9 9 9 9 9 9 9 9 9 9 9 9 8 0 0 0 0 0 0 0 0 0 
0 0 0 0 0 0 0 0 0 0 7 9 9 9 9 9 9 9 9 9 9 9 9 9 35 9 9 9 12 9 9 9 9 9 9 9 35 9 9 9 9 9 9 9 12 9 9 9 9 9 9 9 9 9 9 9 24 22 25 9 9 9 9 9 9 9 9 9 9 9 9 9 9 9 9 9 9 9 9 9 9 9 9 9 9 9 9 9 9 9 8 0 0 0 0 0 0 0 0 0 
0 0 0 0 0 0 0 0 0 0 7 9 9 9 9 9 9 9 9 9 9 12 9 9 9 12 9 9 9 9 11 9 9 9 12 9 9 9 11 9 9 12 9 9 9 9 9 9 9 9 9 9 9 9 9 9 24 22 25 9 9 9 9 9 9 9 9 9 9 9 9 9 9 9 9 9 9 9 9 9 9 9 9 9 9 9 9 9 9 9 8 0 0 0 0 0 0 0 0 0 
0 0 0 0 0 0 0 0 0 0 7 9 9 9 9 9 9 9 9 9 9 9 9 9 9 9 9 9 35 9 9 9 9 9 9 9 11 9 9 9 11 9 9 9 35 9 35 9 35 9 37 9 9 9 9 9 24 22 25 9 9 9 9 9 9 9 9 9 9 9 9 9 9 9 9 9 9 9 9 9 9 9 9 9 9 9 9 9 9 9 8 0 0 0 0 0 0 0 0 0 
0 0 0 0 0 0 0 0 0 0 7 9 9 9 9 9 9 9 9 9 9 9 12 9 37 9 9 9 9 9 9 37 9 9 9 9 9 9 9 9 9 37 9 9 9 9 9 9 9 9 9 9 9 9 9 9 24 22 25 9 9 9 9 9 9 9 9 9 9 9 9 9 9 9 9 9 9 9 9 9 9 9 9 9 9 9 9 9 9 9 8 0 0 0 0 0 0 0 0 0 
0 0 0 0 0 0 0 0 0 0 7 9 9 9 9 9 9 9 9 9 9 9 9 9 9 9 9 9 9 9 9 9 35 9 9 9 9 9 9 9 9 9 9 9 9 9 9 9 9 35 9 9 9 9 9 9 24 22 25 9 9 9 9 9 9 9 9 9 9 9 9 9 9 9 9 9 9 9 9 9 9 9 9 9 9 9 9 9 9 9 8 0 0 0 0 0 0 0 0 0 
0 0 0 0 0 0 0 0 0 0 7 9 9 9 9 9 9 9 9 9 9 9 9 11 9 9 9 11 9 9 9 9 9 35 9 9 9 37 9 9 35 9 9 9 35 9 9 9 35 9 9 9 9 9 9 9 24 22 25 9 9 9 9 9 9 9 9 9 9 9 9 9 9 9 9 9 9 9 9 9 9 9 9 9 9 9 9 9 9 9 8 0 0 0 0 0 0 0 0 0 
0 0 0 0 0 0 0 0 0 0 7 9 9 9 9 9 9 9 9 9 9 9 9 9 9 9 9 9 9 9 9 9 9 9 11 9 9 9 9 9 9 9 35 9 9 12 9 9 9 9 9 9 9 9 9 9 24 22 25 9 9 9 9 9 9 9 9 9 9 9 9 9 9 9 9 9 9 9 9 9 9 9 9 9 9 9 9 9 9 9 8 0 0 0 0 0 0 0 0 0 
0 0 0 0 0 0 0 0 0 0 7 9 9 9 9 9 9 9 9 9 9 9 9 9 9 9 9 9 9 9 9 9 9 9 9 9 9 9 9 11 9 9 9 9 9 9 9 9 9 9 9 9 9 9 9 9 24 22 25 9 9 9 9 9 9 9 9 9 9 9 9 9 9 9 9 9 9 9 9 9 9 9 9 9 9 9 9 9 9 9 8 0 0 0 0 0 0 0 0 0 
0 0 0 0 0 0 0 0 0 0 7 9 9 9 9 9 9 9 9 9 9 9 9 9 12 9 9 9 35 35 9 9 9 9 9 11 9 9 9 9 9 12 9 9 9 9 11 9 9 35 9 9 9 9 9 9 24 22 25 9 9 9 9 9 9 9 9 9 9 9 9 9 9 9 9 9 9 9 9 9 9 9 9 9 9 9 9 9 9 9 8 0 0 0 0 0 0 0 0 0 
0 0 0 0 0 0 0 0 0 0 7 9 9 9 9 9 9 9 9 9 9 9 9 9 9 9 9 9 12 9 9 9 9 9 9 12 9 9 9 37 9 9 9 9 9 9 37 9 9 9 9 9 9 9 9 9 24 22 25 9 9 9 9 9 9 9 9 9 9 9 9 9 9 9 9 9 9 9 9 9 9 9 9 9 9 9 9 9 9 9 8 0 0 0 0 0 0 0 0 0 
0 0 0 0 0 0 0 0 0 0 7 9 9 9 9 9 9 9 9 9 9 9 9 9 9 9 9 9 9 9 9 9 9 35 9 9 9 9 9 9 9 9 12 9 9 9 9 9 9 9 12 9 9 9 9 9 24 22 25 9 9 9 9 9 9 9 9 9 9 9 9 9 9 9 9 9 9 9 9 9 9 9 9 9 9 9 9 9 9 9 8 0 0 0 0 0 0 0 0 0 
0 0 0 0 0 0 0 0 0 0 7 9 9 9 9 9 9 9 9 9 9 9 9 9 9 9 9 9 9 9 9 37 9 9 9 9 9 9 9 9 9 9 9 35 9 9 9 9 9 9 9 9 9 9 9 9 24 22 25 9 9 9 9 9 9 9 9 9 9 9 9 9 9 9 9 9 9 9 9 9 9 9 9 9 9 9 9 9 9 9 8 0 0 0 0 0 0 0 0 0 
0 0 0 0 0 0 0 0 0 0 7 9 9 37 9 9 9 9 9 9 9 9 9 9 9 9 9 9 9 9 9 9 9 9 9 9 9 35 35 9 9 9 9 9 9 9 9 35 9 9 9 9 9 9 9 9 24 22 25 9 9 9 9 9 9 9 9 9 9 9 9 9 9 9 9 9 9 9 9 9 9 9 9 9 9 9 9 9 9 9 8 0 0 0 0 0 0 0 0 0 
0 0 0 0 0 0 0 0 0 0 7 9 37 9 37 10 9 9 9 9 34 34 34 34 34 34 9 9 9 9 9 9 9 9 9 35 9 9 9 9 9 9 9 9 35 9 9 9 9 9 9 9 9 9 9 9 24 22 25 9 9 9 9 9 9 9 9 9 9 9 9 14 9 9 14 9 9 9 9 9 9 9 9 9 9 9 9 9 9 9 8 0 0 0 0 0 0 0 0 0 
0 0 0 0 0 0 0 0 0 0 7 9 9 9 9 9 9 9 9 34 34 9 9 9 14 14 9 9 9 9 9 9 9 9 9 9 9 9 9 9 9 35 9 9 9 9 35 9 9 9 9 9 9 9 9 9 24 22 25 9 9 9 9 9 9 9 9 14 9 9 12 9 14 9 9 11 14 9 9 9 9 9 14 9 9 9 9 9 9 9 8 0 0 0 0 0 0 0 0 0 
0 0 0 0 0 0 0 0 0 0 7 9 10 9 10 9 9 9 34 34 9 9 9 9 14 14 14 33 36 9 9 9 9 9 9 9 9 35 9 9 9 9 9 37 9 9 9 9 9 9 35 9 9 9 9 9 24 22 25 9 9 9 9 9 9 9 9 9 9 14 9 9 9 9 12 9 9 11 9 12 9 11 9 14 9 11 9 9 9 9 8 0 0 0 0 0 0 0 0 0 
0 0 0 0 0 0 0 0 0 0 7 9 9 11 9 9 9 9 33 9 9 9 9 9 9 14 14 33 33 36 36 9 9 9 9 9 9 9 9 9 9 9 9 9 9 9 9 9 9 9 9 9 9 9 9 9 24 22 25 9 9 9 9 9 9 9 9 9 11 9 11 9 14 14 14 9 9 9 14 9 11 9 12 9 14 9 9 14 9 9 8 0 0 0 0 0 0 0 0 0 
0 0 0 0 0 0 0 0 0 0 7 36 9 9 9 9 9 33 9 9 9 9 9 9 9 9 14 53 53 33 54 36 9 9 9 9 9 9 9 9 9 9 9 9 9 9 9 9 35 9 9 9 9 9 9 9 24 22 25 9 9 9 9 9 9 9 9 9 9 9 11 9 14 14 54 54 54 54 9 9 9 14 9 9 14 9 14 9 9 9 8 0 0 0 0 0 0 0 0 0 
0 0 0 0 0 0 0 0 0 0 7 14 36 9 10 9 11 9 33 33 9 9 13 15 9 18 9 53 33 33 36 54 9 9 9 9 9 9 9 9 9 9 9 9 9 9 9 9 9 9 9 9 9 9 9 9 24 22 25 9 9 9 9 9 9 9 14 9 12 9 9 9 14 54 54 33 54 54 54 54 54 54 33 54 9 12 9 9 9 9 8 0 0 0 0 0 0 0 0 0 
0 0 0 0 0 0 0 0 0 0 7 14 36 9 9 9 9 9 33 34 9 9 17 16 9 9 53 53 33 54 36 54 9 9 9 9 9 9 9 9 9 9 9 9 9 9 9 9 9 9 9 9 9 9 9 9 24 22 25 9 9 9 9 9 9 9 9 9 14 9 12 9 14 54 54 54 54 54 36 54 33 54 36 54 9 9 9 9 9 9 8 0 0 0 0 0 0 0 0 0 
0 0 0 0 0 0 0 0 0 0 7 14 35 9 36 9 11 9 9 33 34 34 9 9 9 9 53 33 36 54 54 9 9 9 9 9 9 9 9 9 9 9 9 9 9 9 9 9 9 9 9 9 9 9 9 9 24 22 25 9 9 9 9 9 9 9 9 9 9 9 9 14 9 54 54 33 54 54 54 33 54 54 54 54 9 14 14 12 9 9 8 0 0 0 0 0 0 0 0 0 
0 0 0 0 0 0 0 0 0 0 7 35 14 36 35 9 9 10 9 9 33 9 33 9 9 9 9 36 54 54 9 9 9 9 9 9 9 9 9 9 9 9 9 9 9 9 9 9 9 9 9 9 9 9 9 9 24 22 25 9 9 9 9 9 9 9 9 9 9 14 9 9 9 9 54 54 54 54 54 54 54 33 54 54 9 9 9 9 9 14 8 0 0 0 0 0 0 0 0 0 
0 0 0 0 0 0 0 0 0 0 7 35 35 35 14 36 9 9 9 9 9 33 33 34 34 34 9 9 9 9 9 9 9 9 9 9 9 9 9 9 9 9 9 9 9 9 9 9 9 9 9 9 9 9 9 9 24 22 25 9 9 9 9 9 9 14 9 9 11 9 9 9 9 9 54 54 36 54 54 33 54 54 54 9 9 12 14 9 9 9 8 0 0 0 0 0 0 0 0 0 
0 0 0 0 0 0 0 0 0 0 7 35 35 35 14 35 35 11 9 11 9 9 9 9 9 9 9 9 9 9 9 9 9 9 9 9 9 9 9 9 9 9 9 9 9 9 9 9 9 9 9 9 9 9 9 9 24 22 25 9 9 9 9 9 9 9 9 9 9 14 9 14 50 9 54 54 54 54 54 54 54 54 9 34 51 35 9 14 9 9 8 0 0 0 0 0 0 0 0 0 
0 0 0 0 0 0 0 0 0 0 7 35 35 35 35 14 14 35 35 9 9 10 9 11 9 9 9 9 9 9 9 9 9 9 9 9 9 9 9 9 9 9 9 9 9 9 9 9 9 9 9 9 9 9 9 9 24 22 25 9 9 9 9 9 9 9 9 14 9 14 9 9 50 9 54 36 54 33 54 54 54 54 9 33 51 35 9 9 9 9 8 0 0 0 0 0 0 0 0 0 
0 0 0 0 0 0 0 0 0 0 7 35 35 35 35 35 11 14 9 10 9 9 9 9 9 9 9 9 11 9 9 9 9 9 9 9 9 9 9 9 9 9 9 9 9 9 9 9 9 9 9 9 9 9 9 9 24 22 25 9 9 9 9 9 9 9 9 9 9 9 9 9 50 9 54 54 54 54 54 54 9 9 9 34 51 35 9 14 9 9 8 0 0 0 0 0 0 0 0 0 
0 0 0 0 0 0 0 0 0 0 7 35 35 35 35 35 35 11 35 36 36 9 9 9 9 9 9 9 9 9 10 9 9 9 9 9 9 9 9 9 9 9 9 9 9 9 9 9 9 9 9 9 9 9 9 9 24 22 25 9 9 9 9 9 9 9 9 9 9 9 9 9 50 9 9 54 9 9 9 51 48 47 47 47 52 9 9 9 9 37 8 0 0 0 0 0 0 0 0 0 
0 0 0 0 0 0 0 0 0 0 7 35 35 35 35 35 35 35 14 35 36 9 9 9 9 11 9 9 9 9 9 9 9 9 9 9 9 9 9 9 9 9 9 9 9 9 9 9 9 9 9 9 9 9 9 9 19 26 20 9 9 9 9 9 9 9 9 9 9 9 9 9 49 52 52 49 49 49 49 52 9 9 14 14 9 14 9 9 37 37 8 0 0 0 0 0 0 0 0 0 
0 0 0 0 0 0 0 0 0 0 7 35 35 35 35 35 35 35 14 9 9 36 9 9 9 9 9 9 9 9 9 9 9 9 9 9 9 9 9 9 9 9 9 9 9 9 9 9 9 9 9 9 9 9 9 9 9 9 9 9 9 9 9 9 9 9 9 9 9 9 9 9 9 9 9 9 9 9 9 9 14 14 14 9 9 9 9 37 37 36 8 0 0 0 0 0 0 0 0 0 
0 0 0 0 0 0 0 0 0 0 1 5 5 5 5 5 5 5 5 5 5 5 5 5 5 5 5 5 5 5 5 5 5 5 5 5 5 5 5 5 5 5 5 5 5 5 5 5 5 5 5 5 5 5 5 5 5 5 5 5 5 5 5 5 5 5 5 5 5 5 5 5 5 5 5 5 5 5 5 5 5 5 5 5 5 5 5 5 5 5 2 0 0 0 0 0 0 0 0 0 
0 0 0 0 0 0 0 0 0 0 0 0 0 0 0 0 0 0 0 0 0 0 0 0 0 0 0 0 0 0 0 0 0 0 0 0 0 0 0 0 0 0 0 0 0 0 0 0 0 0 0 0 0 0 0 0 0 0 0 0 0 0 0 0 0 0 0 0 0 0 0 0 0 0 0 0 0 0 0 0 0 0 0 0 0 0 0 0 0 0 0 0 0 0 0 0 0 0 0 0 
0 0 0 0 0 0 0 0 0 0 0 0 0 0 0 0 0 0 0 0 0 0 0 0 0 0 0 0 0 0 0 0 0 0 0 0 0 0 0 0 0 0 0 0 0 0 0 0 0 0 0 0 0 0 0 0 0 0 0 0 0 0 0 0 0 0 0 0 0 0 0 0 0 0 0 0 0 0 0 0 0 0 0 0 0 0 0 0 0 0 0 0 0 0 0 0 0 0 0 0 
0 0 0 0 0 0 0 0 0 0 0 0 0 0 0 0 0 0 0 0 0 0 0 0 0 0 0 0 0 0 0 0 0 0 0 0 0 0 0 0 0 0 0 0 0 0 0 0 0 0 0 0 0 0 0 0 0 0 0 0 0 0 0 0 0 0 0 0 0 0 0 0 0 0 0 0 0 0 0 0 0 0 0 0 0 0 0 0 0 0 0 0 0 0 0 0 0 0 0 0 
0 0 0 0 0 0 0 0 0 0 0 0 0 0 0 0 0 0 0 0 0 0 0 0 0 0 0 0 0 0 0 0 0 0 0 0 0 0 0 0 0 0 0 0 0 0 0 0 0 0 0 0 0 0 0 0 0 0 0 0 0 0 0 0 0 0 0 0 0 0 0 0 0 0 0 0 0 0 0 0 0 0 0 0 0 0 0 0 0 0 0 0 0 0 0 0 0 0 0 0 
0 0 0 0 0 0 0 0 0 0 0 0 0 0 0 0 0 0 0 0 0 0 0 0 0 0 0 0 0 0 0 0 0 0 0 0 0 0 0 0 0 0 0 0 0 0 0 0 0 0 0 0 0 0 0 0 0 0 0 0 0 0 0 0 0 0 0 0 0 0 0 0 0 0 0 0 0 0 0 0 0 0 0 0 0 0 0 0 0 0 0 0 0 0 0 0 0 0 0 0 
0 0 0 0 0 0 0 0 0 0 0 0 0 0 0 0 0 0 0 0 0 0 0 0 0 0 0 0 0 0 0 0 0 0 0 0 0 0 0 0 0 0 0 0 0 0 0 0 0 0 0 0 0 0 0 0 0 0 0 0 0 0 0 0 0 0 0 0 0 0 0 0 0 0 0 0 0 0 0 0 0 0 0 0 0 0 0 0 0 0 0 0 0 0 0 0 0 0 0 0 
0 0 0 0 0 0 0 0 0 0 0 0 0 0 0 0 0 0 0 0 0 0 0 0 0 0 0 0 0 0 0 0 0 0 0 0 0 0 0 0 0 0 0 0 0 0 0 0 0 0 0 0 0 0 0 0 0 0 0 0 0 0 0 0 0 0 0 0 0 0 0 0 0 0 0 0 0 0 0 0 0 0 0 0 0 0 0 0 0 0 0 0 0 0 0 0 0 0 0 0 
0 0 0 0 0 0 0 0 0 0 0 0 0 0 0 0 0 0 0 0 0 0 0 0 0 0 0 0 0 0 0 0 0 0 0 0 0 0 0 0 0 0 0 0 0 0 0 0 0 0 0 0 0 0 0 0 0 0 0 0 0 0 0 0 0 0 0 0 0 0 0 0 0 0 0 0 0 0 0 0 0 0 0 0 0 0 0 0 0 0 0 0 0 0 0 0 0 0 0 0 
0 0 0 0 0 0 0 0 0 0 0 0 0 0 0 0 0 0 0 0 0 0 0 0 0 0 0 0 0 0 0 0 0 0 0 0 0 0 0 0 0 0 0 0 0 0 0 0 0 0 0 0 0 0 0 0 0 0 0 0 0 0 0 0 0 0 0 0 0 0 0 0 0 0 0 0 0 0 0 0 0 0 0 0 0 0 0 0 0 0 0 0 0 0 0 0 0 0 0 0 
