34 34 34 34 34 34 34 34 34 34 34 34 34 34 34 34 34 34 34 34 34 34 34 34 34 34 34 34 34 34 34 34 34 34 34 34 34 34 34 34 34 34 34 34 34 34 34 34 34 34 
34 34 34 34 34 34 34 34 34 34 34 34 34 34 34 34 34 34 34 34 34 34 34 34 34 34 34 34 34 34 34 34 34 34 34 34 34 34 34 34 34 34 34 34 34 34 34 34 34 34 
34 34 34 34 34 34 34 34 34 34 34 34 34 34 34 34 34 34 34 34 34 34 34 34 34 34 34 34 34 34 34 34 34 34 34 34 34 34 34 34 34 34 34 34 34 34 34 34 34 34 
34 34 34 34 34 34 34 34 34 34 34 34 34 34 34 34 34 34 34 34 34 34 34 34 34 34 34 34 34 34 34 34 34 34 34 34 34 34 34 34 34 34 34 34 34 34 34 34 34 34 
34 34 34 34 34 34 34 34 34 34 34 34 34 34 34 34 34 34 34 34 34 34 34 34 34 34 34 34 34 34 34 34 34 34 34 34 34 34 34 34 34 34 34 34 34 34 34 34 34 34 
34 34 34 34 34 34 34 34 34 34 34 34 34 34 34 34 34 34 34 34 34 34 34 34 34 34 34 34 34 34 34 34 34 34 34 34 34 34 34 34 34 34 34 34 34 34 34 34 34 34 
34 34 34 34 34 34 34 34 34 34 34 34 34 34 34 34 34 34 34 34 34 34 34 34 34 34 34 34 34 34 34 34 34 34 34 34 34 34 34 34 34 34 34 34 34 34 34 34 34 34 
34 34 34 34 34 34 34 34 34 34 34 34 34 34 34 34 34 34 34 34 34 34 34 34 34 34 34 34 34 34 34 34 34 34 34 34 34 34 34 34 34 34 34 34 34 34 34 34 34 34 
34 34 34 34 34 34 34 34 34 34 34 34 34 34 34 34 34 34 34 34 34 34 34 34 34 34 34 34 34 34 34 34 34 34 34 34 34 34 34 34 34 34 34 34 34 34 34 34 34 34 
34 34 34 34 34 34 34 34 34 37 42 42 42 42 42 42 42 42 42 42 42 1 31 31 31 31 31 31 1 42 42 42 42 42 42 42 42 42 42 42 38 34 34 34 34 34 34 34 34 34 
34 34 34 34 34 34 34 34 34 40 28 28 28 28 28 8 26 8 8 26 0 1 9 9 9 9 9 9 1 26 8 8 27 27 27 8 8 8 8 8 41 34 34 34 34 34 34 34 34 34
34 34 34 34 34 34 34 34 34 40 28 27 27 28 28 8 26 8 8 8 0 1 9 9 9 9 9 9 1 26 8 8 8 8 26 8 8 8 27 8 41 34 34 34 34 34 34 34 34 34 
34 34 34 34 34 34 34 34 34 40 27 28 27 27 8 8 0 8 27 8 0 1 31 31 30 32 30 30 1 0 10 10 10 8 8 26 27 8 8 8 41 34 34 34 34 34 34 34 34 34
34 34 34 34 34 34 34 34 34 40 27 8 8 8 8 0 8 8 8 8 8 8 8 17 24 18 8 8 0 8 10 10 10 8 8 27 8 8 8 8 41 34 34 34 34 34 34 34 34 34 
34 34 34 34 34 34 34 34 34 40 27 8 27 8 11 0 8 27 8 8 8 8 8 19 20 21 8 8 8 8 10 10 10 26 8 8 8 27 27 27 41 34 34 34 34 34 34 34 34 34 
34 34 34 34 34 34 34 34 34 40 8 8 8 11 8 8 8 26 8 8 8 8 8 19 20 21 8 27 8 27 8 8 8 8 27 8 8 8 8 8 41 34 34 34 34 34 34 34 34 34 
34 34 34 34 34 34 34 34 34 40 27 8 8 8 8 10 0 8 8 8 8 8 8 19 20 21 8 8 8 8 8 8 8 8 27 8 26 8 8 8 41 34 34 34 34 34 34 34 34 34 
34 34 34 34 34 34 34 34 34 40 8 8 11 27 8 27 8 8 8 8 8 8 8 19 20 21 8 8 8 8 8 8 8 8 8 8 8 27 8 8 41 34 34 34 34 34 34 34 34 34 
34 34 34 34 34 34 34 34 34 40 8 27 8 27 10 8 8 8 8 8 8 8 8 19 20 21 8 8 8 8 8 8 27 8 8 8 8 8 8 8 41 34 34 34 34 34 34 34 34 34 
34 34 34 34 34 34 34 34 34 40 8 8 8 8 8 8 8 27 8 8 11 8 8 19 20 21 8 8 8 8 8 8 8 8 8 8 8 8 8 8 41 34 34 34 34 34 34 34 34 34 
34 34 34 34 34 34 34 34 34 40 27 8 27 8 8 8 8 8 8 8 8 8 8 19 20 21 8 8 8 8 11 8 8 8 8 8 8 8 8 8 41 34 34 34 34 34 34 34 34 34 
34 34 34 34 34 34 34 34 34 40 28 8 8 8 8 27 8 17 24 24 24 18 8 19 20 21 8 8 8 8 8 8 11 8 11 8 8 10 8 11 41 34 34 34 34 34 34 34 34 34 
34 34 34 34 34 34 34 34 34 40 8 8 11 7 0 7 7 19 25 25 25 21 8 19 20 21 8 8 8 8 8 8 8 8 8 8 11 11 8 10 41 34 34 34 34 34 34 34 34 34
34 34 34 34 34 34 34 34 34 40 8 11 8 0 7 0 7 19 25 25 25 21 8 19 20 21 8 8 8 27 8 8 8 8 11 8 8 8 8 8 41 34 34 34 34 34 34 34 34 34
34 34 34 34 34 34 34 34 34 40 8 8 27 0 7 7 11 19 25 25 25 21 8 19 20 21 8 8 10 8 8 8 8 27 8 8 27 8 8 8 41 34 34 34 34 34 34 34 34 34
34 34 34 34 34 34 34 34 34 40 27 8 8 7 8 8 8 15 22 22 22 16 8 19 20 21 8 8 8 8 8 27 8 8 8 27 8 8 8 8 41 34 34 34 34 34 34 34 34 34
34 34 34 34 34 34 34 34 34 40 8 8 27 8 11 8 23 8 8 11 8 8 8 19 20 21 8 8 8 8 8 8 8 8 8 27 8 27 8 8 41 34 34 34 34 34 34 34 34 34 
34 34 34 34 34 34 34 34 34 40 28 8 8 8 8 8 8 8 8 8 8 8 8 19 20 21 8 10 8 8 10 8 10 8 8 8 8 8 27 27 41 34 34 34 34 34 34 34 34 34 
34 34 34 34 34 34 34 34 34 40 8 8 11 8 8 8 8 8 8 8 8 8 8 19 20 21 8 8 8 8 8 8 8 8 8 8 8 8 27 8 41 34 34 34 34 34 34 34 34 34 
34 34 34 34 34 34 34 34 34 40 8 8 8 8 8 8 8 8 8 8 8 8 8 19 20 21 8 8 8 27 8 8 11 8 27 8 27 27 8 8 41 34 34 34 34 34 34 34 34 34 
34 34 34 34 34 34 34 34 34 40 8 8 8 8 8 8 8 8 8 8 8 8 8 19 20 21 11 8 8 8 11 8 8 8 8 8 27 8 8 8 41 34 34 34 34 34 34 34 34 34 
34 34 34 34 34 34 34 34 34 40 8 8 8 8 8 8 8 8 8 8 8 8 8 19 20 21 8 8 8 8 8 8 10 8 11 8 8 27 8 8 41 34 34 34 34 34 34 34 34 34 
34 34 34 34 34 34 34 34 34 40 8 8 8 8 8 8 8 8 8 8 8 8 8 19 20 21 8 8 10 8 8 8 8 8 8 8 8 8 27 8 41 34 34 34 34 34 34 34 34 34 
34 34 34 34 34 34 34 34 34 40 8 28 8 8 8 8 0 8 8 11 11 8 8 19 20 21 8 8 8 8 8 8 8 8 0 8 8 10 8 8 41 34 34 34 34 34 34 34 34 34 
34 34 34 34 34 34 34 34 34 40 8 8 28 8 8 8 3 4 8 8 10 11 8 19 20 21 8 8 8 8 11 8 0 8 8 8 10 10 8 10 41 34 34 34 34 34 34 34 34 34 
34 34 34 34 34 34 34 34 34 40 8 11 27 10 8 8 6 5 2 8 11 0 8 19 20 21 8 8 8 8 8 27 8 27 8 11 10 11 10 10 41 34 34 34 34 34 34 34 34 34
34 34 34 34 34 34 34 34 34 40 11 27 26 27 8 8 8 8 8 8 0 8 8 19 20 21 8 8 8 27 0 8 8 27 8 11 27 10 11 27 41 34 34 34 34 34 34 34 34 34 
34 34 34 34 34 34 34 34 34 40 26 26 26 26 27 8 8 26 8 0 8 8 8 19 20 21 8 8 8 8 27 8 8 8 27 27 27 27 27 27 41 34 34 34 34 34 34 34 34 34 
34 34 34 34 34 34 34 34 34 40 8 26 26 26 27 8 23 8 26 8 8 8 8 19 20 21 8 8 0 8 8 8 8 27 8 27 27 26 27 0 41 34 34 34 34 34 34 34 34 34 
34 34 34 34 34 34 34 34 34 40 26 8 26 8 8 8 8 8 26 8 8 8 8 15 22 16 8 8 8 8 8 8 8 8 27 27 27 27 27 27 41 34 34 34 34 34 34 34 34 34 
34 34 34 34 34 34 34 34 34 35 39 39 39 39 39 39 39 39 39 39 39 39 39 39 39 39 39 39 39 39 39 39 39 39 39 39 39 39 39 39 36 34 34 34 34 34 34 34 34 34 
34 34 34 34 34 34 34 34 34 34 34 34 34 34 34 34 34 34 34 34 34 34 34 34 34 34 34 34 34 34 34 34 34 34 34 34 34 34 34 34 34 34 34 34 34 34 34 34 34 34 
34 34 34 34 34 34 34 34 34 34 34 34 34 34 34 34 34 34 34 34 34 34 34 34 34 34 34 34 34 34 34 34 34 34 34 34 34 34 34 34 34 34 34 34 34 34 34 34 34 34 
34 34 34 34 34 34 34 34 34 34 34 34 34 34 34 34 34 34 34 34 34 34 34 34 34 34 34 34 34 34 34 34 34 34 34 34 34 34 34 34 34 34 34 34 34 34 34 34 34 34 
34 34 34 34 34 34 34 34 34 34 34 34 34 34 34 34 34 34 34 34 34 34 34 34 34 34 34 34 34 34 34 34 34 34 34 34 34 34 34 34 34 34 34 34 34 34 34 34 34 34 
34 34 34 34 34 34 34 34 34 34 34 34 34 34 34 34 34 34 34 34 34 34 34 34 34 34 34 34 34 34 34 34 34 34 34 34 34 34 34 34 34 34 34 34 34 34 34 34 34 34 
34 34 34 34 34 34 34 34 34 34 34 34 34 34 34 34 34 34 34 34 34 34 34 34 34 34 34 34 34 34 34 34 34 34 34 34 34 34 34 34 34 34 34 34 34 34 34 34 34 34 
34 34 34 34 34 34 34 34 34 34 34 34 34 34 34 34 34 34 34 34 34 34 34 34 34 34 34 34 34 34 34 34 34 34 34 34 34 34 34 34 34 34 34 34 34 34 34 34 34 34 
34 34 34 34 34 34 34 34 34 34 34 34 34 34 34 34 34 34 34 34 34 34 34 34 34 34 34 34 34 34 34 34 34 34 34 34 34 34 34 34 34 34 34 34 34 34 34 34 34 34 
34 34 34 34 34 34 34 34 34 34 34 34 34 34 34 34 34 34 34 34 34 34 34 34 34 34 34 34 34 34 34 34 34 34 34 34 34 34 34 34 34 34 34 34 34 34 34 34 34 34 
